
*TR  0000111122223333444455556666777788889999AAAABBBBCCCCDDDDEEEEFFFF

*00  <---ALIEN.PICS.12-----------------------------------------------
*01  ----ALIEN.PICS.12-----------------------------------------------
*02  ----ALIEN.PICS.12-----------------------------------------------
*03  ----ALIEN.PICS.12-----------------------------------------------
*04  ----ALIEN.PICS.12-----------------------------------------------
*05  ----ALIEN.PICS.12-----------------------------------------------
*06  ----ALIEN.PICS.12-----------------------------------------------
*07  ----ALIEN.PICS.12-----------------------------------------------
*08  ----ALIEN.PICS.12-----------------------------------------------
*09  ----ALIEN.PICS.12-----------------------------------------------
*0A  ----ALIEN.PICS.12---------------------->........................
*0B
*0C  <---ALIEN.DESC.12-------------------------------------->........
*0D  <---ALIEN.DATA.12-----------------------------------------------
*0E  ----ALIEN.DATA.12-----------------------------------------------
*0F  ----ALIEN.DATA.12-------------------------------------->........
*10  <---CONTROL17-------------------------------------------------->
*11  <---CONTROL15---------------------------------->................
*12
*13  <---FIGHT.LOADER--->............................................
*14  <---DIAGNOSE------------------------------------------->........
*15  <---ALIEN.ID----------->........<---ELEVATOR------------------->
*16  <---VIEWPORT----------------------->............................
*17  <---RUUIK------------------------------------------>............
*18
*19
*1A
*1B
*1C
*1D
*1E
*1F
*20
*21
*22

*TR  0000111122223333444455556666777788889999AAAABBBBCCCCDDDDEEEEFFFF

*00  <---ALIEN.PICS.345----------------------------------------------
*01  ----ALIEN.PICS.345----------------------------------------------
*02  ----ALIEN.PICS.345----------------------------------------------
*03  ----ALIEN.PICS.345----------------------------------------------
*04  ----ALIEN.PICS.345----------------------------------------------
*05  ----ALIEN.PICS.345----------------------------------------------
*06  ----ALIEN.PICS.345----------------------------------------------
*07  ----ALIEN.PICS.345----------------------------------------------
*08  ----ALIEN.PICS.345----------------------------------------------
*09  ----ALIEN.PICS.345----------------------------------------------
*0A  ----ALIEN.PICS.345----------------------------------------------
*0B  ----ALIEN.PICS.345--------------------------------------------->
*0C  <---ALIEN.DESC.345--------------------------------->............
*0D  <---ALIEN.DATA.345----------------------------------------------
*0E  ----ALIEN.DATA.345----------------------------------------------
*0F  ----ALIEN.DATA.345--------------------------------->............
*10  <---CONTROL13---------------------------------->................
*11  <---CONTROL11---------------------------------->................
*12  <---CONTROL9----------------------------------->................
*13  <---FIGHT.LOADER--->............................................
*14  <---DIAGNOSE------------------------------------------->........
*15  <---ALIEN.ID----------->........<---ELEVATOR------------------->
*16  <---KEY.DOOR--------------------------------------->............
*17
*18
*19
*1A
*1B
*1C
*1D
*1E
*1F
*20
*21
*22

*TR  0000111122223333444455556666777788889999AAAABBBBCCCCDDDDEEEEFFFF

*00
*01
*02
*03
*04
*05
*06
*07
*08
*09
*0A
*0B
*0C
*0D
*0E  <---FIGHT.LOADER2------>
*0F  <---FIGHT.SHARED----------------------------------------------->
*10  <---FIGHT.COMMAND-----------------------------------------------
*11  ----FIGHT.COMMAND-----------------------------------------------
*12  ----FIGHT.COMMAND---------------------------------------------->
*13
*14  <---FIGHT.NARRATOR----------------------------------------------
*15  ----FIGHT.NARRATOR----------------------------------------------
*16  ----FIGHT.NARRATOR----------------------------------------------
*17  ----FIGHT.NARRATOR--------------------------------------------->
*18
*19
*1A
*1B  <---HALLS-------------------------------------------------------
*1C  ------------------->
*1D  <---AWARDER---------------------------------------->............
*1E  <---DEAD.GROUP------------------------------------->............
*1F
*20  <---REFORMAT--------------->....................................
*21
*22

*TR  0000111122223333444455556666777788889999AAAABBBBCCCCDDDDEEEEFFFF
